NO ./north.xpm
SO ./south.xpm
WE ./west.xpm
EA ./east.xpm

F 220,100   # seulement deux composantes
C 225,30,0

1111
1N01
1001
1111
