NO textures/bluestone.xpm
SO textures/purplestone.xpm
WE textures/mossy.xpm
EA textures/redbrick.xpm

F 255,0,0
C 0,255,255

1111111
1000001
100000111
100N00001
100000111
1000001
1111111
