NO textures/simonkraft/wet_sponge.xpm
SO textures/simonkraft/cyan_concrete.xpm
WE textures/simonkraft/soul_sand.xpm
EA textures/simonkraft/netherrack_02.xpm

F 164,169,20
C 153,204,255

PROP frame_time 0.00666

ENT ghoul (1.5, 1.5)

1111111
1000001
100N001
1000001
1111111
