NO textures/bluestone.xpm
SO textures/purplestone.xpm
WE textures/mossy.xpm
EA        textures/redbrick.xpm

F       220,100,0
C 225,30,0


        111111111111111111111111
111111111110000000011000000001111
        1011000001110000000000001
        1001000000000000000000001
111111111011000001110000000000001
100000000011000001110111111111111
11110111111111011100000010001
11110111111111011101010110001
11000000110101011100001E10001
10000000000000001100000110001
10000000000000001101010010001
110000011101010111110111100111
11110111 1110101 101111010001
11111111 1111111 111111111111
          
