NO textures/bluestone.xpm
SO textures/purplestone.xpm
WE textures/mossy.xpm
EA textures/redbrick.xpm

F 220,100,0
C 225,30,0

1111
1N00
100 
1111
