NO textures/bluestone.xpm
SO textures/purplestone.xpm
F 0,0,0
EA textures/redbrick.xpm

C 0,0,0
WE textures/mossy.xpm

111111111111111111
100000000010000001
100010000100010001
1000E0000000000001
100010000100010001
100000000010000001
111111111111111111
