NO textures/bluestone.xp
SO textures/purplestone.xpm
WE textures/mossy.xpm
EA textures/redbrick.xpm

F 184,113,39
C 51,198,227

        1111111111111111111111111
1111111111100000000110000 0001111
        1011000001110000000000001
        10010000000000000E0000001
111111111011000001110000000000001
100000000011000001110111111111111
11110111111111011100000010001
11110111111111011101010110001
11000000110101011100001010001
10000000000000001100000110001
10000000000000001101010010001
11000001110101011111011110011
11110111 1110101 101111010001
11111111 1111111 111111111111
