NO[location]
SO[location]
WE[location]
SE[location]

F[RGB]
C[RGB]


111111111111111111111111
100000000000000000000001
100000000000000000000001
100000000000000000000001
100000000000000000000001
100000000000000000000001
100000000000000000000001
100000000000000000000001
100000000000000000000001
100000000000000000000001
100000000000000000000001
100000000000000000000001
10000000000N000000000001
100000000000000000000001
111111111111111111111111